##########
#S     #E#
# ###### #
#        #
##########